2 21 7278 3785 1383 7356 4055 813 7389 3721 1283 7433 1333 2660 4695 1206 3731 2149 5074 7592 2615 593 634 
2 14 5827 6542 7607 5468 7582 7593 3609 4110 7600 7608 993 3944 7592 4462 
2 21 1664 3334 7287 4039 7312 238 5591 5735 3852 5946 903 2340 7416 1371 716 49 7483 7473 1336 7502 21 
2 8 21 3254 1423 985 874 5124 1236 5753 
2 13 2340 3596 6497 7331 4507 5173 4634 2354 3936 3918 3354 4380 6165 
2 32 3721 5648 1237 3094 7392 1216 5824 7407 1520 5133 1945 2047 1953 6417 3017 4733 1990 576 5741 2700 5460 539 2824 4048 3403 6027 5610 501 4020 4802 479 7305 
3 12 1953 3764 3527 7521 2553 5052 7614 568 1279 4679 869 252 
3 2 1664 7278 
3 25 1664 3178 5047 3004 3279 3129 7202 2239 1200 6182 3788 7159 810 3270 5553 4898 1334 5469 4475 7113 7112 7094 4062 5674 442 
2 9 442 654 5893 6053 833 4458 5281 774 7264 
2 6 5824 1313 7354 3353 883 3063 
2 10 3063 2719 7292 7311 4067 639 5086 7239 4479 3299 
3 14 1664 347 3898 7170 7183 3097 6255 7162 7156 6244 2507 7153 2543 537 
3 19 7156 441 3960 6543 3201 4148 1325 4159 7178 7194 277 1185 7197 1967 6538 1078 4196 5145 780 
2 35 5255 214 3230 4942 4950 5273 186 4238 3879 7456 2511 3648 5651 1308 7451 1431 7441 4673 226 2244 2506 7431 981 2440 4645 2296 7461 7459 4391 3935 3065 7446 7462 811 120 
2 14 5196 6304 2541 1205 2488 846 1294 4143 295 3953 1223 6943 6048 2576 
2 9 2576 5864 6955 4622 329 4375 6259 3092 3012 
1 5 3953 2250 1862 7010 2049 
2 5 5196 4260 7076 997 94 
1 3 94 3989 7053 
1 19 7053 4860 7039 314 6311 2447 6202 2459 7049 881 2077 4216 7004 783 3082 6970 6948 3900 6490 
1 10 31 2106 4294 6321 3820 1196 7316 1126 3291 484 
2 3 186 3121 748 
2 17 748 3572 7571 10 7627 4399 3119 1660 5897 6574 3453 6323 2687 5825 2926 3104 4823 
1 6 2926 7733 598 4774 948 2223 
1 4 7305 5150 2592 5852 
2 3 6165 7393 4259 
2 13 4898 7054 1794 7027 6066 6558 455 4954 6892 2628 4249 6922 6879 
2 6 6066 1469 5579 566 4889 6946 
1 5 2239 2051 1477 4172 1841 
1 4 1477 6258 7077 2524 
1 4 2530 4662 1020 6221 
3 9 6221 7786 7761 7756 2068 4334 3023 4068 252 
1 4 4022 2078 4444 5276 
1 5 4022 6447 290 4492 4227 
1 4 290 7024 5322 7083 
1 6 2351 7489 11 1386 7408 1284 
1 10 2351 5190 7559 3489 3025 5049 5563 5451 5955 3159 
1 6 1284 7371 3215 1852 1744 7236 
1 2 1244 4922 
1 6 2017 2461 5755 7428 2711 7453 
1 4 5755 3346 1576 4404 
1 5 2017 6156 4794 5344 7256 
1 13 1284 1217 588 7329 1516 4517 4647 3111 2694 1595 1354 6562 3895 
1 8 3895 897 7272 969 584 5389 7313 2564 
1 3 355 7404 664 
1 6 5389 4 7361 1079 7397 664 
1 3 664 5747 1504 
1 8 3895 7230 3800 6541 1711 7131 7098 530 
1 8 7098 4105 1353 5327 490 6997 736 4940 
4 3 780 4737 7171 
2 4 874 4251 6589 4259 
3 7 4380 4727 4326 3799 3436 3488 5145 
1 6 5531 2281 4732 5012 6804 4194 
1 5 6024 1376 6907 3310 5243 
1 4 5243 6919 4012 4940 
1 4 5243 3978 4353 4873 
1 5 3895 7231 1613 7172 2653 
1 8 7236 5573 7224 6073 3930 3747 7213 1849 
1 4 4922 2123 2475 7371 
1 6 2351 1652 7495 6065 7515 4404 
1 8 3159 7536 3663 5743 7527 3651 5251 5428 
1 6 3131 5531 169 6307 1538 4022 
1 3 5573 2020 6581 
1 3 355 87 7417 
1 9 3111 5398 3891 808 79 6286 1135 194 1504 
1 2 2017 1244 
1 4 5344 7290 2623 4179 
1 2 7256 6073 
1 6 530 4731 3166 7132 7145 2653 
1 6 2653 357 7209 7245 4597 2564 
1 10 5428 41 7496 7478 32 7464 7476 2864 3979 7417 
2 2 329 7014 
2 6 5196 2099 5400 5542 3602 1967 
1 23 3900 6192 4924 6880 115 414 4805 837 918 3946 896 6835 4640 4688 5015 5283 249 4385 2454 4838 5663 6847 6849 
2 22 6849 1594 1782 6826 3885 879 1245 6813 3825 6832 495 6229 4606 6582 222 5567 1710 6872 4982 144 4741 6946 
1 2 5033 4606 
1 7 5663 4036 6901 2118 6945 1133 2488 
2 5 7446 7424 3741 7401 484 
1 12 7305 6416 5625 1769 5932 422 4464 3013 7283 4177 3709 7264 
2 3 7112 4013 3299 
1 6 639 3677 7353 1950 2252 1990 
1 6 2530 3350 269 6219 6082 634 
2 4 252 4903 7774 954 
2 4 954 5393 3167 4614 
1 9 5393 436 3942 7879 3473 98 5384 7961 3018 
2 3 1020 1282 1162 
2 5 3071 1716 4917 7695 1162 
2 10 1206 5783 4894 7605 279 1733 6423 4627 4421 1716 
2 4 4068 2242 4038 3071 
1 8 1733 3381 6161 125 5583 3657 1896 5052 
1 4 7711 6461 3389 593 
2 7 5674 4799 546 1532 6958 6942 1654 
2 5 5741 3273 7344 963 3709 
2 4 7382 1260 5842 5255 
1 7 985 5970 3892 4302 1551 7664 4879 
1 4 5827 7658 1646 6342 
1 10 5827 3479 3384 6318 2363 6301 3361 4370 1433 3254 
1 2 4173 7521 
1 6 2223 2977 215 5485 493 5418 
2 5 3266 7494 7463 4510 2824 
1 6 3315 1924 6086 1092 5457 4055 
1 2 7364 813 
1 4 7077 315 5870 7059 
1 4 7014 5577 3700 7059 
1 2 537 4159 
1 2 1851 6082 
1 3 1363 3999 5824 
2 4 479 3336 789 484 
1 3 7498 2358 3230 
1 3 7083 4549 6581 
1 12 1744 4663 3209 1729 30 2219 4274 5212 377 2527 1955 7098 
1 7 5398 4837 7443 7455 4986 1215 3159 
1 3 7478 574 664 
1 8 4012 5506 6930 1008 6934 2569 1056 4022 
1 3 5428 5608 194 
1 7 6562 1292 6544 3715 6004 7427 194 
1 4 5645 4587 2911 4841 
3 3 5645 1506 4381 
1 10 4841 152 5998 1911 8695 8697 2905 5223 2406 1192 
1 6 5645 2503 5017 5833 1085 487 
1 4 1142 2287 4282 8586 
1 6 4282 1374 5713 4702 3251 2435 
1 10 6055 5828 1894 8651 8658 4286 8653 6081 8648 2596 
1 3 6055 6019 1497 
1 9 634 1691 5626 7765 5183 2171 802 7912 1362 
1 13 1362 2893 6394 2163 1805 3860 1401 1427 5991 1869 3899 8263 3021 
1 8 1869 2284 3519 1303 8210 4242 3490 8209 
2 8 4112 1193 4225 3620 5640 1908 5320 6253 
1 6 6253 1614 8178 3503 2201 8209 
1 3 3503 746 8148 
1 14 8482 2539 498 1988 4569 4699 6591 8338 1519 8292 121 3966 4393 3503 
1 4 17 6133 8140 3620 
1 11 1869 2508 108 8228 1790 6521 2446 1484 1518 2577 8249 
1 7 5210 6467 4582 6404 1377 6481 8249 
1 6 4553 7991 754 3256 5290 3261 
1 7 3261 2761 5329 1 1596 2547 8249 
1 15 5668 6213 4501 67 1539 447 8456 2820 6366 652 2183 1317 8277 4580 5210 
1 7 6342 4094 4626 7773 2631 7808 2477 
1 8 4553 6293 5493 1080 7854 2743 7836 2477 
1 14 4175 2044 4991 8372 3614 4955 8356 3376 8395 2955 8398 303 8388 4699 
1 3 5151 3666 4991 
1 6 1331 6463 5913 85 2981 8482 
1 7 3576 2251 5184 2639 873 1451 1362 
1 4 788 8492 4364 2661 
1 5 788 4897 8498 773 8509 
1 6 2661 2801 5689 6294 6287 8586 
1 4 4744 6228 5539 7722 
1 8 7722 5957 5662 7719 2840 7710 6353 2664 
1 4 2831 804 6817 1710 
1 2 6811 1710 
1 2 5714 5033 
1 3 5033 281 1843 
1 3 5714 2982 2831 
1 3 1843 991 3825 
1 12 2210 4168 3583 3447 7007 5533 2342 3901 389 1603 1705 914 
1 12 914 5924 2196 454 7225 3462 5764 73 5302 2350 7254 31 
1 8 120 7471 3621 7477 1365 6343 7538 3266 
1 3 3266 7552 2270 
1 3 3205 7376 2340 
1 2 3936 6419 
1 4 6419 3366 4953 1336 
1 3 4407 7466 1363 
1 3 2363 1905 2568 
1 2 2568 4495 
