1 21 7278 3785 1383 7356 4055 813 7389 3721 1283 7433 1333 2660 4695 1206 3731 2149 5074 7592 2615 593 634 
1 13 7592 3944 993 7608 7600 4110 3609 7593 7582 5468 7607 6542 5827 
1 21 1664 3334 7287 4039 7312 238 5591 5735 3852 5946 903 2340 7416 1371 716 49 7483 7473 1336 7502 21 
1 8 21 3254 1423 985 874 5124 1236 5753 
1 13 2340 3596 6497 7331 4507 5173 4634 2354 3936 3918 3354 4380 6165 
2 32 3721 5648 1237 3094 7392 1216 5824 7407 1520 5133 1945 2047 1953 6417 3017 4733 1990 576 5741 2700 5460 539 2824 4048 3403 6027 5610 501 4020 4802 479 7305 
1 12 1953 3764 3527 7521 2553 5052 7614 4671 1326 6332 4068 252 
3 2 1664 7278 
1 25 1664 3178 5047 3004 3279 3129 7202 2239 1200 6182 3788 7159 810 3270 5553 4898 1334 5469 4475 7113 7112 7094 4062 5674 442 
1 9 442 654 5893 6053 833 4458 5281 774 7264 
1 6 5824 1313 7354 3353 883 3063 
1 10 3063 2719 7292 7311 4067 639 5086 7239 4479 3299 
3 14 1664 347 3898 7170 7183 3097 6255 7162 7156 6244 2507 7153 2543 537 
1 19 7156 441 3960 6543 3201 4148 1325 4159 7178 7194 277 1185 7197 1967 6538 1078 4196 5145 780 
1 35 5255 214 3230 4942 4950 5273 186 4238 3879 7456 2511 3648 5651 1308 7451 1431 7441 4673 226 2244 2506 7431 981 2440 4645 2296 7461 7459 4391 3935 3065 7446 7462 811 120 
1 14 5196 6304 2541 1205 2488 846 1294 4143 295 3953 1223 6943 6048 2576 
1 7 2576 5864 6955 4622 329 4375 6259 
1 5 3953 2250 1862 7010 2049 
1 5 5196 4260 7076 997 94 
1 3 94 3989 7053 
1 9 7053 4860 7039 314 6311 2447 6202 2459 7049 
1 13 479 4347 789 484 3291 1126 7316 1196 3820 6321 4294 2106 31 
1 3 186 3121 748 
1 17 748 3572 7571 10 7627 4399 3119 1660 5897 6574 3453 6323 2687 5825 2926 3104 4823 
1 6 2926 7733 598 4774 948 2223 
1 4 7305 5150 2592 5852 
1 3 6165 7393 4259 
1 12 4898 7054 1794 7027 6066 6558 455 4954 6892 2628 4249 6922 
1 6 6066 1469 5579 566 4889 6946 
1 4 2239 2051 1477 4172 
1 4 1477 6258 7077 2524 
1 4 2530 4662 1020 6221 
1 8 6221 7786 7761 7756 2068 4334 3023 4068 
1 4 4022 2078 4444 5276 
1 5 4022 6447 290 4492 4227 
1 4 290 7024 5322 7083 
1 6 2351 7489 11 1386 7408 1284 
1 10 2351 5190 7559 3489 3025 5049 5563 5451 5955 3159 
1 6 1284 7371 3215 1852 1744 7236 
1 3 2017 1244 4922 
1 6 2017 2461 5755 7428 2711 7453 
1 4 5755 3346 1576 4404 
1 5 2017 6156 4794 5344 7256 
1 13 1284 1217 588 7329 1516 4517 4647 3111 2694 1595 1354 6562 3895 
1 8 3895 897 7272 969 584 5389 7313 2564 
1 3 355 7404 664 
1 6 5389 4 7361 1079 7397 664 
1 5 664 5747 1504 7480 5428 
1 8 3895 7230 3800 6541 1711 7131 7098 530 
1 8 7098 4105 1353 5327 490 6997 736 4940 
1 3 780 4737 7171 
1 4 874 4251 6589 4259 
1 7 4380 4727 4326 3799 3436 3488 5145 
